40 40 40 40 40 40 40 40
40 40 40 40 40 40 40 40
20 20 20 20 20 20 20 20
20 20 20 20 20 20 20 20
20 20 20 20 20 20 20 20
20 20 20 20 20 20 20 20
0 0 0 0 0 0 0 0
0 0 0 0 0 0 0 0