50 50 50 50 50 50 50 50
50 50 50 50 50 50 50 50
40 40 40 40 40 40 40 40
30 30 30 30 30 30 30 30
30 30 30 30 30 30 30 30
20 20 20 20 20 20 20 20
0 0 0 0 0 0 0 0
0 0 0 0 0 0 0 0