90 90 90 90 90 90 90 90
60 60 60 60 60 60 60 60
50 50 50 50 50 50 50 50
50 50 50 50 50 50 50 50
50 50 50 50 50 50 50 50
50 50 50 50 50 50 50 50
0 0 0 0 0 0 0 0
0 0 0 0 0 0 0 0