50 50 50 50 50 50 50 50
50 50 50 50 50 50 50 50
50 50 50 50 50 50 50 50
50 50 50 50 50 50 50 50
40 40 40 40 40 40 40 40
40 40 40 40 40 40 40 40
0 0 0 0 0 0 0 0
0 0 0 0 0 0 0 0